Nie przechodzić przez kredową linię.	Do not walk over the chalk line.
Niektóre dzieci rzucały kamieniami nad naszym płotem.	Some kids were throwing rocks over our fence.
Samolot leciał naprawdę nisko nad naszymi głowami.	A plane flew really low over our heads.
Nie widzę niczego ponad ścianią.	I can't see anything over the wall.
Potknął się i przewrócił.	He tripped and fell over.
Nasz związek jest skończony.	Our relationship is over.
Gra skończyła się szybko.	The game was over quickly.
przez	over
Czy ona chciałaby pójść z nami?	Would she like to come with us?
Wolisz miejsce przy oknie czy przejściu?	Would you prefer a window or aisle seat?
Czy mógłbyś usiąść?	Would you please have a seat?
Czy mógłbyś zamknąć drzwi?	Would you please close the door?
Jak można to zrobić?	How would you do this?
Mój tata będzie wiedział jak to naprawić.	My dad would know how to fix this.
Chciałbym zapomnieć to, co powiedział.	I would forget about what he said.
Byłoby bardziej gorąco tutaj, gdyby nie mieli klimatyzacji.	It would be hotter in here if we didn't have an air conditioner.
Chciałbym pójść z tobą, ale nie mam samochodu.	I would go with you, but I don't have a car.
chcieć	would
Ona słucha dobrze.	She listens well.
Ona jest dobrze opłacana w tej pracy.	She is well paid in that job.
Program został dobrze napisany.	The program was well developed.
Armia była dobrze uzbrojona w karabiny.	The army was well armed with guns.
On dobrze jest znany.	He is well known.
Zdaję sobie sprawę z sytuacji.	I am well aware of the situation.
Dziewczyna wpadła do suchej studni.	The girl fell into a dry well.
dobrze	well
Każdy kraj ma swój własny język i tradycję.	Each country has its own language and tradition.
Psa trzymano w klatce przez długi czas.	The dog was kept in its cage for a long time.
Drzewo traci większość swoich gałęzi.	The tree has lost most of its branches.
Firma zwalnia swoich pracowników.	The company is laying off its employees.
Jego	Its
Mój pies ma bardzo spokojny  temperament.	My dog has a very even temperament.
Staramy się mieć parzystą liczbę studentów.	We are trying to have an even number of students.
Potrzebuję równą powierzchnięby postawić to.	I need an even surface to put this on.
Powierzchnia wody jest bardzo gładka.	The surface of the water is very even.
Te grupy są bardzo wyrównane.	The groups are very even.
On nawet nie słyszał o tym zespole.	He hasn't even heard of that band.
Jej dzień poszedł jeszcze lepiej.	Her day got even better.
Ona nawet nie rozpoczęła swojej pracy domowej.	She hasn't even started her homework.
Lubi go jeszcze bardziej niż wcześniej.	She likes him even more than before.
Nawet	Even
Dostał się znów w tarapaty w szkole.	He got into trouble again at school.
Dzieci wskoczyły do jeziora.	The kids jumped into the lake.
Mój telefon przypadkowo wpadł do kosza.	My phone accidentally fell into the trash can.
Pobiegłem do starego przyjaciela wczoraj.	I ran into an old friend yesterday.
Poszliśmy do pokoju na rozmowę.	We went into the room to talk.
Proszę położyć swoje naczynia do zlewu.	Please put your dishes into the sink.
do	Into
Które buty lepiej pasują?	Which shoe fits better?
Która książka jest twoja?	Which book is yours?
Która sukienka podoba ci się?	Which dress do you like?
Który	Which
Powinniśmy tam pojechać.	We should go there.
Chodźmy tam usiąść.	Let's sit there.
Tam	There
Spojrzałem na zegarek.	I looked at the clock.
Spójrz na te wszystkie elementy.	Take a look at all of these items.
Jedzmy kolację o siódmej.	Let's eat dinner at seven o'clock.
Spotkamy się w południe.	I'll meet you at noon.
Jest wiele psów w parku.	There are many dogs at the park.
Byli w szkole.	They were at school.
Widziałem ich na filmach.	I saw them at the movies.
Ona jest w banku.	She is at the bank.
Znalazłem to w sklepie.	I found this at the store.
Spotkajmy się w bibliotece.	Let's meet at the library.
W	At
To jest brzydki obraz.	That is an ugly painting.
Ona je jabłko.	She is eating an apple.
to	An