Pójdę po tobie.	I'll go after your turn.
Wziął prysznic po meczu.	He took a shower after the game.
po	after
Proszę przyjdź do mnie.	Please come to me.
Zdarzyło mi się.	It happened to me.
Daj mi jeden dobry powód.	Give me one good reason.ts.
mi	me
Nie mam konkretnej daty.	I don't have a specific date.
Jaki jest Twój szczególny cel?	What is your specific aim?
konkretny	specific
Kto determinuje twój los w życiu?	Who is determining your lot in life?
Nasz dom został wybudowany na działce.	Our home was built on a lot.
Mieli wiele pracy do zrobienia.	They had a lot of work to do.
los, plac, bardzo	lot
Sukienka jest ładna. Może nie być odpowiednia do pracy, mimo to.	The dress is pretty. It may not be appropriate for work, though.
Jestem w pracy, chociaż wolałbym być raczej na Hawajach.	I am at work, thought I would rather be in Hawaii.
Poszedłem do szkoły, chociaż bardzo chciałem zostać w domu.	I went to school, though I really wanted to stay home.
chociaż	though
Oni nigdy nie obejmują nas w swoich planach.	They never include us in their plans.
Dokument zawiera dane surowe.	The document includes raw data.
zawierać	include
Chociaż mam dobre oceny, ja naprawdę nie lubię szkoły.	Although I get good grades, I really don't like school.
Chociaż widziałem ten film kilka razy, wciąż płaczę na końcu.	Although I've seen this movie several times, I still cry at the end.
mimo że	although